.#############.########.
.....#..................
#.##.#.##########.######
...#.......#.......#...S
.#.#######.#####.#.#.#.#
#....#...#.#...#.#.#.#.#
#.##...#.#.###.#.#.#.#.#
#.#..#.#.#.....#.#...#.#
######G#########.#####..